NO textures/window.xpm
SO textures/simonkraft/cobblestone.xpm
WE textures/simonkraft/soul_soil.xpm
EA textures/simonkraft/mossy_cobblestone1.xpm

C 144,224,239
F 204,197,176

1111111111111111111111111111
1000000000000000000000000001
10000000000000100000000W0001
1000010000000111000000100001
1000000000000010000000000111
1000000000000000000000000001
1111111111111111111111111111